<Level File>
1;Level 01
10,10;1,1;8,8


##########
# #   # ##
# # # #  #
# # # ## #
# # # #  #
# # # # ##
# # # #  #
# # # ## #
#   #    #
##########