<Level File>
3;Level 3
15,14;6,1;13,1
9,3,12,9;9,5,12,7
9,11,smart,right
6,11,fire;8,11,fire;6,7,water;7,7,water;8,7,water;6,8,water;8,8,water;6,9,water;7,9,water;8,9,water
13,11,fire boots;7,11,water boots
###############
####       5  #
#### # #   ####
#### # #   ####
#@ # #@#   # r#
#  R ###   R @#
#### r     ####
#### #   # #  #
#### # @ # ####
#### #   # #  #
#### ##### #  #
####@      #  #
###############