<Level File>
3;Level 3
16,11;1,1;10,9
5,1,13,9;6,9,13,4



################
# #@# #g#b##@ r#
# # # # # ###G##
# # # # # ##   #
# #B# # # ##   #
#          #####
##B#R# # #5#r @#
## # # # # ##R##
## # # # # #   #
##@#@# #b# #   #
################