<Level File>
5;Level 5
17,16;15,15;2,10

8,11,line,right;12,12,line,left;9,13,line,right;11,14,line,left;14,13,wall,down;15,6,wall,left;16,10,wall,up;4,7,wall,down
9,7,fire
12,15,fire boots
#################
######@    ######
######     ######
######     ######
######     ######
###   ## ####   #
### # ## #### # #
### #           #
### # ### ###   #
# 3 # ### ### # #
### # #     #   #
### # #     #   #
### # #     # # #
###   #     #   #
####@##@    #   #
#################