<Level File>
1;Level 01
10,10;1,1;8,1
1,4,8,6
5,8,smart,up
6,1,fire
3,1,fire boots
##########
# #   #  #
#r# # #  #
# #@# ##5#
#R#@# #  #
# #@# # ##
# #@# #  #
# #@# ## #
#   #    #
##########