<Level File>
3;Level 3
16,11;1,1;10,9
5,1,13,9;6,9,13,4
1,5,line,right;


################
# #@# #c#b##@ d#
# # # # # ###C##
# # # # # ##   #
# #A# # # ##   #
#          #####
##B#E# # #5#e @#
## # # # # ##D##
## # # # # #   #
##@#@# #@# #   #
################